########
###----#
--#-##-#
#P--##-E
########
